########MMM########
########MoM########
########MoM########
##MMMMMMMoM########
##MooooMMoM##MMM###
##MoMMoMMoMM#MPM###
##MoooOootoM#MoM###
#MMMMMoMMMoMMMoM###
#MooooLooEoOoooM###
#MMMMMMMMMMOMMMM###
##########MOoooM###
##########MoMMoM###
##########MooooM###
##########MMMMMM###
###################