###################
###################
###################
##MMMMMM###########
##MooooM#####MMM###
##MoMMoMMMMM#MPM###
##MoooOooooM#MoM###
#MMMMMoMMMoMMMoM###
#MEooooM#MoooooM###
#MMMMMMM#MMMMMMM###
###################
###################
###################
###################
###################